12 8
-1 -1 -1 -1 -1 -1 -1 -1 
-1 -1 41 44 41 -1 -1 -1 
-1 -1 241 241 -1 -1 -1 -1 
-1 121 243 243 -1 -1 -1 -1 
-1 241 241 241 -1 -1 -1 -1 
-1 1 4 1 243 41 44 41 
-1 -1 241 241 241 241 -1 -1 
-1 -1 -1 -1 243 121 124 -1 
-1 -1 -1 -1 -1 241 241 241 
-1 -1 -1 -1 -1 161 243 243 
-1 -1 -1 -1 -1 241 241 241 
-1 -1 -1 -1 -1 -1 243 241 
